20
12
8 8 8 8 8 8 8 8 8 8 8 8 8 8 8 8 8 8 8 8
8 8 8 8 8 8 8 8 8 8 8 8 8 8 8 8 8 8 8 8
1 4 8 8 8 8 8 8 8 8 8 8 8 8 8 8 8 8 1 4
9 5 8 8 8 8 8 8 8 8 8 8 8 8 8 8 8 8 9 5
9 5 8 8 8 8 3 8 8 8 8 8 8 8 8 3 8 8 9 5
9 5 8 8 8 3 2 3 8 8 8 8 8 8 3 2 8 8 9 5
9 5 8 8 8 8 8 8 8 8 8 8 8 8 8 8 8 8 9 5
9 5 8 8 8 8 8 8 8 8 8 3 8 8 8 8 8 8 9 5
9 5 8 8 8 8 8 8 8 8 8 8 8 8 8 8 8 8 9 5
7 5 8 8 8 8 8 8 3 3 8 8 8 8 8 8 8 8 9 7
6 5 8 8 8 3 8 8 8 8 8 8 8 8 8 8 8 8 9 6
3 3 3 3 3 2 3 3 3 3 3 3 3 3 3 3 3 3 3 3
