20
12
9 9 9 9 9 9 9 9 9 9 9 9 9 9 9 9 9 9 9 9
7 9 9 9 9 9 9 9 9 9 9 9 9 9 9 9 9 9 9 9
6 9 9 9 9 9 9 9 9 9 9 9 9 9 9 9 4 9 9 9
1 1 1 1 1 1 1 1 1 1 1 1 1 1 1 1 1 9 9 9
9 9 9 9 9 9 9 9 9 9 9 9 9 9 9 9 9 9 9 9
9 9 9 9 9 9 9 9 9 9 9 9 9 9 9 9 9 9 9 9
9 9 9 4 9 9 9 9 9 9 9 9 9 9 9 9 9 9 9 9
9 9 9 1 1 1 1 1 1 1 1 1 1 1 1 1 1 1 1 1
9 9 9 9 9 9 9 9 9 9 9 9 9 9 9 9 9 9 9 9
4 9 9 9 9 9 9 9 9 9 9 9 9 9 9 9 9 9 9 7
4 9 9 9 9 9 9 9 9 9 9 9 9 9 9 9 9 9 9 6
1 1 1 1 1 1 1 1 1 1 1 1 1 1 1 1 1 1 1 1